ID,DATE_ADMINISTERED,NEW_1ST_DOSES,NEW_2ND_DOSES,NEW_SINGLE_DOSES,NEW_SERIES_COMPLETED,NEW_RECIPIENTS,CUMULATIVE_1ST_DOSES,CUMULATIVE_2ND_DOSES,CUMULATIVE_SINGLE_DOSES,CUMULATIVE_SERIES_COMPLETED,CUMULATIVE_RECIPIENTS,NEW_BOOSTER_DOSES,NEW_BOOSTER_RECIPIENTS,CUMULATIVE_BOOSTER_DOSES,CUMULATIVE_BOOSTER_RECIPIENTS
1,2020-12-11,1,0,0,0,1,1,0,0,0,1,0,0,0,0
2,2020-12-12,1,1,0,1,2,2,1,0,1,3,0,0,0,0
3,2020-12-13,0,0,0,0,0,2,1,0,1,3,0,0,0,0
4,2020-12-14,1,0,0,0,1,3,1,0,1,4,0,0,0,0
5,2020-12-15,14,0,0,0,14,17,1,0,1,18,0,0,0,0
6,2020-12-16,235,0,0,0,235,252,1,0,1,253,0,0,0,0
7,2020-12-17,418,0,0,0,418,670,1,0,1,671,0,0,0,0
8,2020-12-18,932,1,0,1,933,1602,2,0,2,1604,0,0,0,0
9,2020-12-19,644,0,0,0,644,2246,2,0,2,2248,0,0,0,0
10,2020-12-20,496,2,0,2,498,2742,4,0,4,2746,0,0,0,0
11,2020-12-21,1178,0,0,0,1178,3920,4,0,4,3924,0,0,0,0
12,2020-12-22,1423,1,0,1,1424,5343,5,0,5,5348,0,0,0,0
13,2020-12-23,1433,6,0,6,1439,6776,11,0,11,6787,0,0,0,0
14,2020-12-24,865,2,0,2,867,7641,13,0,13,7654,0,0,0,0
15,2020-12-25,47,0,0,0,47,7688,13,0,13,7701,0,0,0,0
16,2020-12-26,260,0,0,0,260,7948,13,0,13,7961,0,0,0,0
17,2020-12-27,282,1,0,1,283,8230,14,0,14,8244,0,0,0,0
18,2020-12-28,1300,6,0,6,1306,9530,20,0,20,9550,0,0,0,0
19,2020-12-29,1433,3,0,3,1436,10963,23,0,23,10986,0,0,0,0
20,2020-12-30,1675,6,0,6,1681,12638,29,0,29,12667,0,0,0,0
21,2020-12-31,1050,0,0,0,1050,13688,29,0,29,13717,0,0,0,0
22,2021-01-01,91,1,0,1,92,13779,30,0,30,13809,0,0,0,0
23,2021-01-02,372,2,0,2,374,14151,32,0,32,14183,0,0,0,0
24,2021-01-03,327,0,0,0,327,14478,32,0,32,14510,0,0,0,0
25,2021-01-04,1894,22,0,22,1896,16372,54,0,54,16406,0,0,0,0
26,2021-01-05,2164,51,0,51,2165,18536,105,0,105,18571,0,0,0,0
27,2021-01-06,1617,281,0,281,1618,20153,386,0,386,20189,0,0,0,0
28,2021-01-07,1626,494,0,494,1628,21779,880,0,880,21817,0,0,0,0
29,2021-01-08,1507,880,0,880,1508,23286,1760,0,1760,23325,0,0,0,0
30,2021-01-09,930,548,0,548,933,24216,2308,0,2308,24258,0,0,0,0
31,2021-01-10,467,469,0,469,468,24683,2777,0,2777,24726,0,0,0,0
32,2021-01-11,1464,1121,0,1121,1465,26147,3898,0,3898,26191,0,0,0,0
33,2021-01-12,1918,1228,0,1228,1919,28065,5126,0,5126,28110,0,0,0,0
34,2021-01-13,2036,863,0,863,2036,30101,5989,0,5989,30146,0,0,0,0
35,2021-01-14,1968,555,0,555,1969,32069,6544,0,6544,32115,0,0,0,0
36,2021-01-15,2406,408,0,408,2410,34475,6952,0,6952,34525,0,0,0,0
37,2021-01-16,2090,173,0,173,2092,36565,7125,0,7125,36617,0,0,0,0
38,2021-01-17,1631,306,0,306,1631,38196,7431,0,7431,38248,0,0,0,0
39,2021-01-18,1150,281,0,281,1151,39346,7712,0,7712,39399,0,0,0,0
40,2021-01-19,1854,891,0,891,1855,41200,8603,0,8603,41254,0,0,0,0
41,2021-01-20,2142,810,0,810,2144,43342,9413,0,9413,43398,0,0,0,0
42,2021-01-21,2619,898,0,898,2619,45961,10311,0,10311,46017,0,0,0,0
43,2021-01-22,2911,520,0,520,2912,48872,10831,0,10831,48929,0,0,0,0
44,2021-01-23,2785,401,0,401,2786,51657,11232,0,11232,51715,0,0,0,0
45,2021-01-24,2211,243,0,243,2211,53868,11475,0,11475,53926,0,0,0,0
46,2021-01-25,3065,1610,0,1610,3067,56933,13085,0,13085,56993,0,0,0,0
47,2021-01-26,3202,1674,0,1674,3204,60135,14759,0,14759,60197,0,0,0,0
48,2021-01-27,3030,1330,0,1330,3030,63165,16089,0,16089,63227,0,0,0,0
49,2021-01-28,2745,1249,0,1249,2748,65910,17338,0,17338,65975,0,0,0,0
50,2021-01-29,3591,1338,0,1338,3591,69501,18676,0,18676,69566,0,0,0,0
51,2021-01-30,3325,471,0,471,3328,72826,19147,0,19147,72894,0,0,0,0
52,2021-01-31,2198,161,0,161,2199,75024,19308,0,19308,75093,0,0,0,0
53,2021-02-01,3008,1121,0,1121,3010,78032,20429,0,20429,78103,0,0,0,0
54,2021-02-02,3027,1592,0,1592,3028,81059,22021,0,22021,81131,0,0,0,0
55,2021-02-03,3864,1308,0,1308,3865,84923,23329,0,23329,84996,0,0,0,0
56,2021-02-04,3954,1221,0,1221,3954,88877,24550,0,24550,88950,0,0,0,0
57,2021-02-05,4840,1410,0,1410,4842,93717,25960,0,25960,93792,0,0,0,0
58,2021-02-06,4876,865,0,865,4879,98593,26825,0,26825,98671,0,0,0,0
59,2021-02-07,3956,582,0,582,3960,102549,27407,0,27407,102631,0,0,0,0
60,2021-02-08,5861,1355,0,1355,5862,108410,28762,0,28762,108493,0,0,0,0
61,2021-02-09,4661,1639,0,1639,4663,113071,30401,0,30401,113156,0,0,0,0
62,2021-02-10,5327,1966,0,1966,5330,118398,32367,0,32367,118486,0,0,0,0
63,2021-02-11,5174,1940,0,1940,5178,123572,34307,0,34307,123664,0,0,0,0
64,2021-02-12,3623,1935,0,1935,3624,127195,36242,0,36242,127288,0,0,0,0
65,2021-02-13,3107,1376,0,1376,3108,130302,37618,0,37618,130396,0,0,0,0
66,2021-02-14,2361,1182,0,1182,2363,132663,38800,0,38800,132759,0,0,0,0
67,2021-02-15,1699,1132,0,1132,1700,134362,39932,0,39932,134459,0,0,0,0
68,2021-02-16,3154,2235,0,2235,3156,137516,42167,0,42167,137615,0,0,0,0
69,2021-02-17,3096,2485,0,2485,3098,140612,44652,0,44652,140713,0,0,0,0
70,2021-02-18,2890,2732,0,2732,2891,143502,47384,0,47384,143604,0,0,0,0
71,2021-02-19,3068,2846,0,2846,3068,146570,50230,0,50230,146672,0,0,0,0
72,2021-02-20,1778,2994,0,2994,1779,148348,53224,0,53224,148451,0,0,0,0
73,2021-02-21,1336,1727,0,1727,1337,149684,54951,0,54951,149788,0,0,0,0
74,2021-02-22,2772,2805,0,2805,2775,152456,57756,0,57756,152563,0,0,0,0
75,2021-02-23,3076,3037,0,3037,3076,155532,60793,0,60793,155639,0,0,0,0
76,2021-02-24,5245,4496,0,4496,5246,160777,65289,0,65289,160885,0,0,0,0
77,2021-02-25,6914,3946,0,3946,6915,167691,69235,0,69235,167800,0,0,0,0
78,2021-02-26,7786,5579,0,5579,7791,175477,74814,0,74814,175591,0,0,0,0
79,2021-02-27,4893,5244,1,5245,4899,180370,80058,1,80059,180490,0,0,0,0
80,2021-02-28,4071,4479,1,4480,4077,184441,84537,2,84539,184567,0,0,0,0
81,2021-03-01,6099,6504,16,6520,6115,190540,91041,18,91059,190682,0,0,0,0
82,2021-03-02,6783,5414,3,5417,6786,197323,96455,21,96476,197468,0,0,0,0
83,2021-03-03,6742,5749,1,5750,6744,204065,102204,22,102226,204212,0,0,0,0
84,2021-03-04,5787,4500,2,4502,5793,209852,106704,24,106728,210005,0,0,0,0
85,2021-03-05,6401,4084,6,4090,6408,216253,110788,30,110818,216413,0,0,0,0
86,2021-03-06,4710,2795,221,3016,4929,220963,113583,251,113834,221342,0,0,0,0
87,2021-03-07,3504,2564,170,2734,3677,224467,116147,421,116568,225019,0,0,0,0
88,2021-03-08,6928,1936,234,2170,7165,231395,118083,655,118738,232184,0,0,0,0
89,2021-03-09,6443,2208,458,2666,6900,237838,120291,1113,121404,239084,0,0,0,0
90,2021-03-10,7378,4180,617,4797,7996,245216,124471,1730,126201,247080,0,0,0,0
91,2021-03-11,6853,2750,1088,3838,7943,252069,127221,2818,130039,255023,0,0,0,0
92,2021-03-12,6195,3711,1515,5226,7712,258264,130932,4333,135265,262735,0,0,0,0
93,2021-03-13,4260,1608,1085,2693,5344,262524,132540,5418,137958,268079,0,0,0,0
94,2021-03-14,3870,3392,274,3666,4147,266394,135932,5692,141624,272226,0,0,0,0
95,2021-03-15,8311,2959,958,3917,9269,274705,138891,6650,145541,281495,0,0,0,0
96,2021-03-16,8581,3278,503,3781,9085,283286,142169,7153,149322,290580,0,0,0,0
97,2021-03-17,9552,3514,657,4171,10211,292838,145683,7810,153493,300791,0,0,0,0
98,2021-03-18,5733,4075,617,4692,6349,298571,149758,8427,158185,307140,0,0,0,0
99,2021-03-19,6490,5850,495,6345,6988,305061,155608,8922,164530,314128,0,0,0,0
100,2021-03-20,5125,3449,471,3920,5597,310186,159057,9393,168450,319725,0,0,0,0
101,2021-03-21,3504,2951,148,3099,3652,313690,162008,9541,171549,323377,0,0,0,0
102,2021-03-22,5129,4227,829,5056,5957,318819,166235,10370,176605,329334,0,0,0,0
103,2021-03-23,5896,5089,651,5740,6546,324715,171324,11021,182345,335880,0,0,0,0
104,2021-03-24,5880,6082,557,6639,6437,330595,177406,11578,188984,342317,0,0,0,0
105,2021-03-25,5470,6209,590,6799,6060,336065,183615,12168,195783,348377,0,0,0,0
106,2021-03-26,5639,6450,229,6679,5866,341704,190065,12397,202462,354243,0,0,0,0
107,2021-03-27,3853,4935,358,5293,4215,345557,195000,12755,207755,358458,0,0,0,0
108,2021-03-28,2751,3909,48,3957,2798,348308,198909,12803,211712,361256,0,0,0,0
109,2021-03-29,4226,7433,196,7629,4423,352534,206342,12999,219341,365679,0,0,0,0
110,2021-03-30,5154,6600,313,6913,5469,357688,212942,13312,226254,371148,0,0,0,0
111,2021-03-31,4948,7463,330,7793,5275,362636,220405,13642,234047,376423,0,0,0,0
112,2021-04-01,5865,6854,1755,8609,7623,368501,227259,15397,242656,384046,0,0,0,0
113,2021-04-02,6841,6440,1890,8330,8729,375342,233699,17287,250986,392775,0,0,0,0
114,2021-04-03,4871,4053,1906,5959,6777,380213,237752,19193,256945,399552,0,0,0,0
115,2021-04-04,3391,3840,1676,5516,5073,383604,241592,20869,262461,404625,0,0,0,0
116,2021-04-05,5943,8448,1959,10407,7903,389547,250040,22828,272868,412528,0,0,0,0
117,2021-04-06,6160,8122,2155,10277,8315,395707,258162,24983,283145,420843,0,0,0,0
118,2021-04-07,6914,7917,2359,10276,9274,402621,266079,27342,293421,430117,0,0,0,0
119,2021-04-08,4733,5367,4464,9831,9196,407354,271446,31806,303252,439313,0,0,0,0
120,2021-04-09,6647,6045,3353,9398,9998,414001,277491,35159,312650,449311,0,0,0,0
121,2021-04-10,6914,4473,1857,6330,8772,420915,281964,37016,318980,458083,0,0,0,0
122,2021-04-11,4964,3604,1173,4777,6139,425879,285568,38189,323757,464222,0,0,0,0
123,2021-04-12,4920,4767,1185,5952,6115,430799,290335,39374,329709,470337,0,0,0,0
124,2021-04-13,5610,5548,16,5564,5632,436409,295883,39390,335273,475969,0,0,0,0
125,2021-04-14,6422,7159,3,7162,6435,442831,303042,39393,342435,482404,0,0,0,0
126,2021-04-15,8436,5916,3,5919,8448,451267,308958,39396,348354,490852,0,0,0,0
127,2021-04-16,7824,5606,41,5647,7869,459091,314564,39437,354001,498721,0,0,0,0
128,2021-04-17,7139,3205,2,3207,7148,466230,317769,39439,357208,505869,0,0,0,0
129,2021-04-18,4495,2663,3,2666,4504,470725,320432,39442,359874,510373,0,0,0,0
130,2021-04-19,7012,4184,4,4188,7028,477737,324616,39446,364062,517401,0,0,0,0
131,2021-04-20,8795,4474,3,4477,8803,486532,329090,39449,368539,526204,0,0,0,0
132,2021-04-21,7288,4940,7,4947,7314,493820,334030,39456,373486,533518,0,0,0,0
133,2021-04-22,6515,5115,1,5116,6531,500335,339145,39457,378602,540049,0,0,0,0
134,2021-04-23,6489,4720,2,4722,6514,506824,343865,39459,383324,546563,0,0,0,0
135,2021-04-24,4702,3521,0,3521,4729,511526,347386,39459,386845,551292,0,0,0,0
136,2021-04-25,2941,2127,7,2134,2956,514467,349513,39466,388979,554248,0,0,0,0
137,2021-04-26,4259,4448,18,4466,4309,518726,353961,39484,393445,558557,0,0,0,0
138,2021-04-27,4543,4698,180,4878,4736,523269,358659,39664,398323,563293,0,0,0,0
139,2021-04-28,5210,4910,207,5117,5438,528479,363569,39871,403440,568731,0,0,0,0
140,2021-04-29,4762,5156,219,5375,4997,533241,368725,40090,408815,573728,0,0,0,0
141,2021-04-30,4176,7186,213,7399,4408,537417,375911,40303,416214,578136,0,0,0,0
142,2021-05-01,1719,5299,125,5424,1867,539136,381210,40428,421638,580003,0,0,0,0
143,2021-05-02,980,4230,106,4336,1104,540116,385440,40534,425974,581107,0,0,0,0
144,2021-05-03,2238,7011,175,7186,2432,542354,392451,40709,433160,583539,0,0,0,0
145,2021-05-04,2244,7148,269,7417,2522,544598,399599,40978,440577,586061,0,0,0,0
146,2021-05-05,2291,6927,317,7244,2612,546889,406526,41295,447821,588673,0,0,0,0
147,2021-05-06,1880,8998,464,9462,2354,548769,415524,41759,457283,591027,0,0,0,0
148,2021-05-07,1693,8659,286,8945,1994,550462,424183,42045,466228,593021,0,0,0,0
149,2021-05-08,1100,7625,134,7759,1254,551562,431808,42179,473987,594275,0,0,0,0
150,2021-05-09,941,5626,90,5716,1028,552503,437434,42269,479703,595303,0,0,0,0
151,2021-05-10,980,6351,263,6614,1248,553483,443785,42532,486317,596551,0,0,0,0
152,2021-05-11,1447,6992,225,7217,1678,554930,450777,42757,493534,598229,0,0,0,0
153,2021-05-12,1482,6658,451,7109,1937,556412,457435,43208,500643,600166,0,0,0,0
154,2021-05-13,4123,7278,215,7493,4357,560535,464713,43423,508136,604523,0,0,0,0
155,2021-05-14,2959,6619,183,6801,3166,563494,471332,43606,514937,607689,0,0,0,0
156,2021-05-15,3223,4972,56,5028,3313,566717,476304,43662,519965,611002,0,0,0,0
157,2021-05-16,2004,3271,58,3329,2084,568721,479575,43720,523294,613086,0,0,0,0
158,2021-05-17,2415,5000,175,5175,2609,571136,484575,43895,528469,615695,0,0,0,0
159,2021-05-18,1838,6874,176,7050,2020,572974,491449,44071,535519,617715,0,0,0,0
160,2021-05-19,2163,5209,266,5475,2429,575137,496658,44337,540994,620144,0,0,0,0
161,2021-05-20,1520,4548,244,4792,1764,576657,501206,44581,545786,621908,0,0,0,0
162,2021-05-21,1587,5429,191,5620,1778,578244,506635,44772,551406,623686,0,0,0,0
163,2021-05-22,2172,2574,93,2667,2264,580416,509209,44865,554073,625950,0,0,0,0
164,2021-05-23,862,1054,79,1133,943,581278,510263,44944,555206,626893,0,0,0,0
165,2021-05-24,1336,2802,175,2977,1510,582614,513065,45119,558183,628403,0,0,0,0
166,2021-05-25,1109,2449,228,2677,1334,583723,515514,45347,560860,629737,0,0,0,0
167,2021-05-26,1115,2791,180,2971,1297,584838,518305,45527,563831,631034,0,0,0,0
168,2021-05-27,1162,2399,194,2593,1356,586000,520704,45721,566424,632390,0,0,0,0
169,2021-05-28,1315,2347,174,2521,1490,587315,523051,45895,568945,633880,0,0,0,0
170,2021-05-29,798,1170,95,1265,892,588113,524221,45990,570210,634772,0,0,0,0
171,2021-05-30,387,558,41,599,431,588500,524779,46031,570809,635203,0,0,0,0
172,2021-05-31,102,180,7,187,109,588602,524959,46038,570996,635312,0,0,0,0
173,2021-06-01,1103,2340,201,2541,1302,589705,527299,46239,573537,636614,0,0,0,0
174,2021-06-02,828,1571,126,1697,951,590533,528870,46365,575234,637565,0,0,0,0
175,2021-06-03,942,2856,189,3045,1130,591475,531726,46554,578279,638695,0,0,0,0
176,2021-06-04,1226,4356,143,4499,1368,592701,536082,46697,582778,640063,0,0,0,0
177,2021-06-05,878,2854,144,2998,1020,593579,538936,46841,585776,641083,0,0,0,0
178,2021-06-06,374,1897,40,1937,414,593953,540833,46881,587713,641497,0,0,0,0
179,2021-06-07,867,2710,150,2860,1015,594820,543543,47031,590573,642512,0,0,0,0
180,2021-06-08,799,1886,162,2048,959,595619,545429,47193,592621,643471,0,0,0,0
181,2021-06-09,664,1596,152,1748,814,596283,547025,47345,594369,644285,0,0,0,0
182,2021-06-10,753,1611,195,1806,948,597036,548636,47540,596175,645233,0,0,0,0
183,2021-06-11,924,2070,166,2236,1090,597960,550706,47706,598411,646323,0,0,0,0
184,2021-06-12,728,2195,166,2361,890,598688,552901,47872,600772,647213,0,0,0,0
185,2021-06-13,223,656,43,699,266,598911,553557,47915,601471,647479,0,0,0,0
186,2021-06-14,825,1563,147,1710,972,599736,555120,48062,603181,648451,0,0,0,0
187,2021-06-15,691,1137,134,1271,825,600427,556257,48196,604452,649276,0,0,0,0
188,2021-06-16,651,1071,188,1259,836,601078,557328,48384,605711,650112,0,0,0,0
189,2021-06-17,655,1155,191,1346,845,601733,558483,48575,607057,650957,0,0,0,0
190,2021-06-18,755,1436,170,1606,923,602488,559919,48745,608663,651880,0,0,0,0
191,2021-06-19,440,876,117,993,554,602928,560795,48862,609656,652434,0,0,0,0
192,2021-06-20,268,347,34,381,303,603196,561142,48896,610037,652737,0,0,0,0
193,2021-06-21,609,464,112,576,721,603805,561606,49008,610613,653458,0,0,0,0
194,2021-06-22,579,945,115,1060,692,604384,562551,49123,611673,654150,0,0,0,0
195,2021-06-23,584,782,135,917,712,604968,563333,49258,612590,654862,0,0,0,0
196,2021-06-24,523,901,170,1071,692,605491,564234,49428,613661,655554,0,0,0,0
197,2021-06-25,671,1080,104,1184,774,606162,565314,49532,614845,656328,0,0,0,0
198,2021-06-26,495,844,87,931,582,606657,566158,49619,615776,656910,0,0,0,0
199,2021-06-27,239,295,34,329,273,606896,566453,49653,616105,657183,0,0,0,0
200,2021-06-28,541,875,98,973,638,607437,567328,49751,617078,657821,0,0,0,0
201,2021-06-29,504,772,102,874,605,607941,568100,49853,617952,658426,0,0,0,0
202,2021-06-30,515,733,70,803,584,608456,568833,49923,618755,659010,0,0,0,0
203,2021-07-01,503,635,129,764,631,608959,569468,50052,619519,659641,0,0,0,0
204,2021-07-02,611,853,81,934,691,609570,570321,50133,620453,660332,0,0,0,0
205,2021-07-03,342,486,71,557,412,609912,570807,50204,621010,660744,0,0,0,0
206,2021-07-04,11,10,0,10,11,609923,570817,50204,621020,660755,0,0,0,0
207,2021-07-05,396,521,45,566,440,610319,571338,50249,621586,661195,0,0,0,0
208,2021-07-06,553,1032,94,1126,645,610872,572370,50343,622712,661840,0,0,0,0
209,2021-07-07,405,649,95,744,496,611277,573019,50438,623456,662336,0,0,0,0
210,2021-07-08,424,614,111,725,532,611701,573633,50549,624181,662868,0,0,0,0
211,2021-07-09,518,694,97,791,614,612219,574327,50646,624972,663482,0,0,0,0
212,2021-07-10,291,340,40,380,330,612510,574667,50686,625352,663812,0,0,0,0
213,2021-07-11,198,291,18,309,216,612708,574958,50704,625661,664028,0,0,0,0
214,2021-07-12,526,706,88,794,613,613234,575664,50792,626455,664641,0,0,0,0
215,2021-07-13,412,503,77,580,487,613646,576167,50869,627035,665128,0,0,0,0
216,2021-07-14,442,548,97,645,538,614088,576715,50966,627680,665666,0,0,0,0
217,2021-07-15,479,491,51,542,528,614567,577206,51017,628222,666194,0,0,0,0
218,2021-07-16,565,586,47,633,611,615132,577792,51064,628855,666805,0,0,0,0
219,2021-07-17,357,428,31,459,388,615489,578220,51095,629314,667193,0,0,0,0
220,2021-07-18,195,212,15,227,210,615684,578432,51110,629541,667403,0,0,0,0
221,2021-07-19,581,565,71,636,649,616265,578997,51181,630177,668052,0,0,0,0
222,2021-07-20,463,393,73,466,534,616728,579390,51254,630643,668586,0,0,0,0
223,2021-07-21,561,499,61,560,619,617289,579889,51315,631203,669205,0,0,0,0
224,2021-07-22,525,486,64,550,587,617814,580375,51379,631753,669792,0,0,0,0
225,2021-07-23,572,546,74,620,645,618386,580921,51453,632373,670437,0,0,0,0
226,2021-07-24,343,397,42,439,384,618729,581318,51495,632812,670821,0,0,0,0
227,2021-07-25,232,101,6,107,237,618961,581419,51501,632919,671058,0,0,0,0
228,2021-07-26,664,426,89,515,752,619625,581845,51590,633434,671810,0,0,0,0
229,2021-07-27,612,447,73,520,682,620237,582292,51663,633954,672492,0,0,0,0
230,2021-07-28,609,419,79,498,685,620846,582711,51742,634452,673177,0,0,0,0
231,2021-07-29,613,397,113,510,724,621459,583108,51855,634962,673901,0,0,0,0
232,2021-07-30,613,504,97,601,710,622072,583612,51952,635563,674611,0,0,0,0
233,2021-07-31,440,274,42,316,481,622512,583886,51994,635879,675092,0,0,0,0
234,2021-08-01,238,150,16,166,254,622750,584036,52010,636045,675346,0,0,0,0
235,2021-08-02,693,460,75,535,767,623443,584496,52085,636580,676113,0,0,0,0
236,2021-08-03,575,405,75,480,645,624018,584901,52160,637060,676758,0,0,0,0
237,2021-08-04,595,397,80,477,675,624613,585298,52240,637537,677433,0,0,0,0
238,2021-08-05,640,392,102,494,742,625253,585690,52342,638031,678175,0,0,0,0
239,2021-08-06,688,530,64,594,751,625941,586220,52406,638625,678926,171,171,171,171
240,2021-08-07,420,300,38,338,458,626361,586520,52444,638963,679384,190,190,361,361
241,2021-08-08,236,174,3,177,239,626597,586694,52447,639140,679623,33,33,394,394
242,2021-08-09,628,496,68,564,694,627225,587190,52515,639704,680317,194,194,588,588
243,2021-08-10,558,406,67,473,624,627783,587596,52582,640177,680941,132,132,720,720
244,2021-08-11,565,476,58,534,620,628348,588072,52640,640711,681561,124,124,844,844
245,2021-08-12,669,440,119,559,786,629017,588512,52759,641270,682347,171,171,1015,1015
246,2021-08-13,739,527,76,603,813,629756,589039,52835,641873,683160,244,244,1259,1259
247,2021-08-14,555,300,44,344,599,630311,589339,52879,642217,683759,261,261,1520,1520
248,2021-08-15,285,202,12,214,297,630596,589541,52891,642431,684056,171,171,1691,1691
249,2021-08-16,742,576,81,657,822,631338,590117,52972,643088,684878,434,434,2125,2125
250,2021-08-17,587,537,85,622,670,631925,590654,53057,643710,685548,510,510,2635,2635
251,2021-08-18,589,511,78,589,665,632514,591165,53135,644299,686213,542,542,3177,3177
252,2021-08-19,564,512,137,649,696,633078,591677,53272,644948,686909,562,562,3739,3739
253,2021-08-20,703,576,72,648,774,633781,592253,53344,645596,687683,689,689,4428,4428
254,2021-08-21,518,436,50,486,568,634299,592689,53394,646082,688251,362,362,4790,4790
255,2021-08-22,319,215,7,222,326,634618,592904,53401,646304,688577,179,179,4969,4969
256,2021-08-23,774,591,81,672,854,635392,593495,53482,646976,689431,615,615,5584,5584
257,2021-08-24,605,520,80,600,682,635997,594015,53562,647576,690113,539,539,6123,6123
258,2021-08-25,506,504,56,560,562,636503,594519,53618,648136,690675,476,476,6599,6599
259,2021-08-26,587,557,110,667,692,637090,595076,53728,648803,691367,563,562,7162,7161
260,2021-08-27,580,608,57,665,637,637670,595684,53785,649468,692004,586,581,7748,7742
261,2021-08-28,430,426,52,478,481,638100,596110,53837,649946,692485,334,328,8082,8070
262,2021-08-29,206,222,2,224,208,638306,596332,53839,650170,692693,182,180,8264,8250
263,2021-08-30,567,562,60,622,626,638873,596894,53899,650792,693319,532,529,8796,8779
264,2021-08-31,469,485,60,545,530,639342,597379,53959,651337,693849,652,651,9448,9430
265,2021-09-01,459,477,46,523,504,639801,597856,54005,651860,694353,558,553,10006,9983
266,2021-09-02,407,498,105,603,513,640208,598354,54110,652463,694866,518,514,10524,10497
267,2021-09-03,499,624,58,682,557,640707,598978,54168,653145,695423,542,533,11066,11030
268,2021-09-04,333,490,34,524,366,641040,599468,54202,653669,695789,242,241,11308,11271
269,2021-09-05,186,214,5,219,191,641226,599682,54207,653888,695980,157,156,11465,11427
270,2021-09-06,72,64,0,64,72,641298,599746,54207,653952,696052,26,24,11491,11451
271,2021-09-07,422,762,49,811,469,641720,600508,54256,654763,696521,542,535,12033,11986
272,2021-09-08,371,546,41,587,411,642091,601054,54297,655350,696932,434,420,12467,12406
273,2021-09-09,384,465,98,563,479,642475,601519,54395,655913,697411,393,386,12860,12792
274,2021-09-10,385,640,40,680,425,642860,602159,54435,656593,697836,442,432,13302,13224
275,2021-09-11,269,440,39,479,307,643129,602599,54474,657072,698143,211,205,13513,13429
276,2021-09-12,163,277,3,280,167,643292,602876,54477,657352,698310,132,128,13645,13557
277,2021-09-13,350,650,31,681,380,643642,603526,54508,658033,698690,364,357,14009,13914
278,2021-09-14,324,528,53,581,376,643966,604054,54561,658614,699066,361,355,14370,14269
279,2021-09-15,352,467,44,511,398,644318,604521,54605,659125,699464,351,342,14721,14611
280,2021-09-16,328,494,81,575,409,644646,605015,54686,659700,699873,323,319,15044,14930
281,2021-09-17,305,566,37,603,342,644951,605581,54723,660303,700215,377,371,15421,15301
282,2021-09-18,239,375,35,410,274,645190,605956,54758,660713,700489,229,221,15650,15522
283,2021-09-19,133,203,5,208,138,645323,606159,54763,660921,700627,136,133,15786,15655
284,2021-09-20,319,478,32,510,351,645642,606637,54795,661431,700978,387,382,16173,16037
285,2021-09-21,268,376,61,437,329,645910,607013,54856,661868,701307,320,312,16493,16349
286,2021-09-22,271,352,28,380,299,646181,607365,54884,662248,701606,288,280,16781,16629
287,2021-09-23,272,370,71,441,340,646453,607735,54955,662689,701946,375,366,17156,16995
288,2021-09-24,320,464,41,505,362,646773,608199,54996,663194,702308,859,855,18015,17850
289,2021-09-25,267,336,35,371,302,647040,608535,55031,663565,702610,978,974,18993,18824
290,2021-09-26,165,179,6,185,171,647205,608714,55037,663750,702781,773,770,19766,19594
291,2021-09-27,353,283,52,335,405,647558,608997,55089,664085,703186,2155,2150,21921,21744
292,2021-09-28,309,400,52,452,360,647867,609397,55141,664537,703546,2028,2024,23949,23768
293,2021-09-29,313,387,87,474,399,648180,609784,55228,665011,703945,2139,2131,26088,25899
294,2021-09-30,309,367,76,443,384,648489,610151,55304,665454,704329,2143,2133,28231,28032
295,2021-10-01,312,436,40,476,352,648801,610587,55344,665930,704681,2463,2456,30694,30488
296,2021-10-02,198,232,27,259,225,648999,610819,55371,666189,704906,942,939,31636,31427
297,2021-10-03,130,166,5,171,135,649129,610985,55376,666360,705041,678,674,32314,32101
298,2021-10-04,349,311,37,348,386,649478,611296,55413,666708,705427,2232,2228,34546,34329
299,2021-10-05,341,332,54,386,395,649819,611628,55467,667094,705822,2351,2341,36897,36670
300,2021-10-06,265,309,31,340,296,650084,611937,55498,667434,706118,2237,2230,39134,38900
301,2021-10-07,285,290,55,345,340,650369,612227,55553,667779,706458,2143,2139,41277,41039
302,2021-10-08,302,313,49,362,351,650671,612540,55602,668141,706809,2533,2528,43810,43567
303,2021-10-09,204,201,24,225,228,650875,612741,55626,668366,707037,1077,1074,44887,44641
304,2021-10-10,125,128,5,133,130,651000,612869,55631,668499,707167,684,678,45571,45319
305,2021-10-11,313,238,25,263,337,651313,613107,55656,668762,707504,2364,2361,47935,47680
306,2021-10-12,302,305,57,362,360,651615,613412,55713,669124,707864,2706,2700,50641,50380
307,2021-10-13,296,296,43,339,340,651911,613708,55756,669463,708204,2422,2413,53063,52793
308,2021-10-14,267,247,69,316,334,652178,613955,55825,669779,708538,2145,2135,55208,54928
309,2021-10-15,313,360,40,400,353,652491,614315,55865,670179,708891,2751,2745,57959,57673
310,2021-10-16,153,169,37,206,190,652644,614484,55902,670385,709081,1074,1071,59033,58744
311,2021-10-17,94,111,4,115,98,652738,614595,55906,670500,709179,637,637,59670,59381
312,2021-10-18,287,318,66,384,353,653025,614913,55972,670884,709532,2379,2367,62049,61748
313,2021-10-19,278,264,35,299,314,653303,615177,56007,671183,709846,2529,2521,64578,64269
314,2021-10-20,248,266,12,278,259,653551,615443,56019,671461,710105,2296,2294,66874,66563
315,2021-10-21,252,241,47,288,300,653803,615684,56066,671749,710405,2088,2077,68962,68640
316,2021-10-22,306,272,44,316,351,654109,615956,56110,672065,710756,3620,3615,72582,72255
317,2021-10-23,212,156,21,177,233,654321,616112,56131,672242,710989,1432,1425,74014,73680
318,2021-10-24,86,75,3,78,89,654407,616187,56134,672320,711078,779,775,74793,74455
319,2021-10-25,355,306,34,340,390,654762,616493,56168,672660,711468,3471,3465,78264,77920
320,2021-10-26,332,304,36,340,367,655094,616797,56204,673000,711835,3844,3841,82108,81761
321,2021-10-27,345,265,21,286,367,655439,617062,56225,673286,712202,4009,4000,86117,85761
322,2021-10-28,318,267,33,300,354,655757,617329,56258,673586,712556,4144,4139,90261,89900
323,2021-10-29,371,307,43,350,413,656128,617636,56301,673936,712969,5218,5208,95479,95108
324,2021-10-30,207,175,33,208,241,656335,617811,56334,674144,713210,1972,1964,97451,97072
325,2021-10-31,147,109,5,114,152,656482,617920,56339,674258,713362,1131,1128,98582,98200
326,2021-11-01,421,301,45,346,466,656903,618221,56384,674604,713828,4539,4532,103121,102732
327,2021-11-02,407,302,39,341,443,657310,618523,56423,674945,714271,5084,5075,108205,107807
328,2021-11-03,411,284,33,317,444,657721,618807,56456,675262,714715,4788,4777,112993,112584
329,2021-11-04,483,266,35,301,520,658204,619073,56491,675563,715235,4966,4956,117959,117540
330,2021-11-05,1231,351,49,400,1285,659435,619424,56540,675963,716520,6070,6059,124029,123599
331,2021-11-06,1746,158,26,184,1772,661181,619582,56566,676147,718292,2422,2413,126451,126012
332,2021-11-07,955,87,5,92,960,662136,619669,56571,676239,719252,1234,1231,127685,127243
333,2021-11-08,1745,261,41,302,1784,663881,619930,56612,676541,721036,5044,5030,132729,132273
334,2021-11-09,1719,268,33,301,1752,665600,620198,56645,676842,722788,4613,4601,137342,136874
335,2021-11-10,1628,269,22,291,1648,667228,620467,56667,677133,724436,4829,4816,142171,141690
336,2021-11-11,1609,189,14,203,1623,668837,620656,56681,677336,726059,4316,4308,146487,145998
337,2021-11-12,1624,279,28,307,1649,670461,620935,56709,677643,727708,5731,5719,152218,151717
338,2021-11-13,2360,134,19,153,2380,672821,621069,56728,677796,730088,2860,2856,155078,154573
339,2021-11-14,764,66,3,69,768,673585,621135,56731,677865,730856,1528,1524,156606,156097
340,2021-11-15,1178,324,34,358,1211,674763,621459,56765,678223,732067,5773,5759,162379,161856
341,2021-11-16,1256,314,35,349,1294,676019,621773,56800,678572,733361,6137,6123,168516,167979
342,2021-11-17,1350,304,28,332,1382,677369,622077,56828,678904,734743,6212,6193,174728,174172
343,2021-11-18,1133,305,19,324,1152,678502,622382,56847,679228,735895,6326,6308,181054,180480
344,2021-11-19,1271,306,33,339,1305,679773,622688,56880,679567,737200,7409,7396,188463,187876
345,2021-11-20,1274,182,11,193,1288,681047,622870,56891,679760,738488,3682,3670,192145,191546
346,2021-11-21,497,114,3,117,501,681544,622984,56894,679877,738989,1630,1625,193775,193171
347,2021-11-22,1461,314,27,341,1489,683005,623298,56921,680218,740478,7168,7151,200943,200322
348,2021-11-23,1205,334,35,369,1243,684210,623632,56956,680587,741721,7244,7227,208187,207549
349,2021-11-24,1034,305,26,331,1061,685244,623937,56982,680918,742782,5995,5973,214182,213522
350,2021-11-25,52,71,4,75,56,685296,624008,56986,680993,742838,206,204,214388,213726
351,2021-11-26,405,278,3,281,413,685701,624286,56989,681274,743251,3335,3326,217723,217052
352,2021-11-27,516,1020,9,1029,524,686217,625306,56998,682303,743775,2614,2603,220337,219655
353,2021-11-28,280,1104,10,1114,290,686497,626410,57008,683417,744065,1450,1449,221787,221104
354,2021-11-29,767,1324,33,1357,803,687264,627734,57041,684774,744868,6315,6297,228102,227401
355,2021-11-30,745,1526,37,1563,784,688009,629260,57078,686337,745652,6671,6652,234773,234053
356,2021-12-01,825,1427,29,1456,858,688834,630687,57107,687793,746510,7094,7076,241867,241129
357,2021-12-02,795,1528,33,1561,832,689629,632215,57140,689354,747342,7154,7140,249021,248269
358,2021-12-03,827,1759,20,1779,849,690456,633974,57160,691133,748191,7556,7539,256577,255808
359,2021-12-04,723,2240,16,2256,739,691179,636214,57176,693389,748930,3745,3727,260322,259535
360,2021-12-05,314,586,2,588,316,691493,636800,57178,693977,749246,1660,1658,261982,261193
361,2021-12-06,825,1162,29,1191,858,692318,637962,57207,695168,750104,7030,7012,269012,268205
362,2021-12-07,937,1100,25,1125,963,693255,639062,57232,696293,751067,7347,7330,276359,275535
363,2021-12-08,895,1202,29,1231,926,694150,640264,57261,697524,751993,7230,7216,283589,282751
364,2021-12-09,804,962,33,995,839,694954,641226,57294,698519,752832,6777,6757,290366,289508
365,2021-12-10,867,1101,27,1128,897,695821,642327,57321,699647,753729,7310,7294,297676,296802
366,2021-12-11,649,1323,22,1345,670,696470,643650,57343,700992,754399,3418,3406,301094,300208
367,2021-12-12,273,392,1,393,275,696743,644042,57344,701385,754674,1530,1527,302624,301735
368,2021-12-13,662,952,14,966,676,697405,644994,57358,702351,755350,5996,5975,308620,307710
369,2021-12-14,793,870,24,894,817,698198,645864,57382,703245,756167,6461,6446,315081,314156
370,2021-12-15,717,882,26,908,744,698915,646746,57408,704153,756911,6337,6317,321418,320473
371,2021-12-16,781,518,23,541,809,699696,647264,57431,704694,757720,6685,6661,328103,327134
372,2021-12-17,855,680,12,692,869,700551,647944,57443,705386,758589,6979,6946,335082,334080
373,2021-12-18,702,646,16,662,718,701253,648590,57459,706048,759307,3812,3789,338894,337869
374,2021-12-19,370,248,1,249,372,701623,648838,57460,706297,759679,2092,2087,340986,339956
375,2021-12-20,901,664,12,676,913,702524,649502,57472,706973,760592,6855,6824,347841,346780
376,2021-12-21,956,602,17,619,976,703480,650104,57489,707592,761568,6862,6837,354703,353617
377,2021-12-22,827,603,16,619,844,704307,650707,57505,708211,762412,6775,6742,361478,360359
378,2021-12-23,777,432,12,444,791,705084,651139,57517,708655,763203,5809,5784,367287,366143
379,2021-12-24,199,129,7,136,206,705283,651268,57524,708791,763409,1706,1699,368993,367842
380,2021-12-25,1,1,0,1,1,705284,651269,57524,708792,763410,7,7,369000,367849
381,2021-12-26,202,158,1,159,203,705486,651427,57525,708951,763613,1021,1010,370021,368859
382,2021-12-27,779,687,8,695,789,706265,652114,57533,709646,764402,5262,5235,375283,374094
383,2021-12-28,766,587,13,600,780,707031,652701,57546,710246,765182,5551,5500,380834,379594
384,2021-12-29,799,514,12,526,812,707830,653215,57558,710772,765994,5364,5339,386198,384933
385,2021-12-30,789,518,11,529,801,708619,653733,57569,711301,766795,5142,5108,391340,390041
386,2021-12-31,254,185,6,191,260,708873,653918,57575,711492,767055,1899,1885,393239,391926
387,2022-01-01,10,41,0,41,10,708883,653959,57575,711533,767065,30,30,393269,391956
388,2022-01-02,173,240,2,242,175,709056,654199,57577,711775,767240,960,950,394229,392906
389,2022-01-03,672,549,14,563,687,709728,654748,57591,712338,767927,4326,4291,398555,397197
390,2022-01-04,585,469,17,486,603,710313,655217,57608,712824,768530,4597,4571,403152,401768
391,2022-01-05,727,473,8,481,738,711040,655690,57616,713305,769268,4419,4376,407571,406144
392,2022-01-06,754,539,11,550,767,711794,656229,57627,713855,770035,4784,4751,412355,410895
393,2022-01-07,756,582,11,593,769,712550,656811,57638,714448,770804,5566,5521,417921,416416
394,2022-01-08,507,524,6,530,513,713057,657335,57644,714978,771317,3067,3045,420988,419461
395,2022-01-09,210,166,0,166,211,713267,657501,57644,715144,771528,1086,1075,422074,420536
396,2022-01-10,617,424,7,431,626,713884,657925,57651,715575,772154,4427,4392,426501,424928
397,2022-01-11,679,457,18,475,697,714563,658382,57669,716050,772851,4396,4363,430897,429291
398,2022-01-12,679,485,12,497,691,715242,658867,57681,716547,773542,4379,4341,435276,433632
399,2022-01-13,585,426,8,434,592,715827,659293,57689,716981,774134,4088,4049,439364,437681
400,2022-01-14,691,382,6,388,698,716518,659675,57695,717369,774832,4509,4452,443873,442133
401,2022-01-15,383,202,1,203,384,716901,659877,57696,717572,775216,2378,2358,446251,444491
402,2022-01-16,174,95,2,97,176,717075,659972,57698,717669,775392,1002,990,447253,445481
403,2022-01-17,443,216,6,222,449,717518,660188,57704,717891,775841,2881,2849,450134,448330
404,2022-01-18,507,406,7,413,514,718025,660594,57711,718304,776355,3356,3316,453490,451646
405,2022-01-19,542,410,7,417,549,718567,661004,57718,718721,776904,3317,3287,456807,454933
406,2022-01-20,495,383,10,393,507,719062,661387,57728,719114,777411,3090,3033,459897,457966
407,2022-01-21,515,341,8,349,524,719577,661728,57736,719463,777935,3374,3303,463271,461269
408,2022-01-22,378,192,4,196,385,719955,661920,57740,719659,778320,1677,1649,464948,462918
409,2022-01-23,144,87,2,89,147,720099,662007,57742,719748,778467,851,832,465799,463750
410,2022-01-24,470,329,10,339,481,720569,662336,57752,720087,778948,2800,2729,468599,466479
411,2022-01-25,462,325,10,335,476,721031,662661,57762,720422,779424,2901,2846,471500,469325
412,2022-01-26,445,400,8,408,455,721476,663061,57770,720830,779879,2690,2626,474190,471951
413,2022-01-27,405,376,7,383,413,721881,663437,57777,721213,780292,2556,2480,476746,474431
414,2022-01-28,486,437,9,446,495,722367,663874,57786,721659,780787,2887,2792,479633,477223
415,2022-01-29,307,307,7,314,314,722674,664181,57793,721973,781101,1588,1518,481221,478741
416,2022-01-30,119,127,0,127,120,722793,664308,57793,722100,781221,652,633,481873,479374
417,2022-01-31,367,314,8,322,378,723160,664622,57801,722422,781599,1980,1886,483853,481260
418,2022-02-01,290,308,9,317,301,723450,664930,57810,722739,781900,1658,1581,485511,482841
419,2022-02-02,308,355,13,368,321,723758,665285,57823,723107,782221,1667,1571,487178,484412
420,2022-02-03,300,291,11,302,311,724058,665576,57834,723409,782532,1585,1508,488763,485920
421,2022-02-04,414,439,6,445,420,724472,666015,57840,723854,782952,1917,1791,490680,487711
422,2022-02-05,280,251,2,253,283,724752,666266,57842,724107,783235,884,822,491564,488533
423,2022-02-06,122,80,0,80,122,724874,666346,57842,724187,783357,509,483,492073,489016
424,2022-02-07,280,276,9,285,290,725154,666622,57851,724472,783647,1440,1331,493513,490347
425,2022-02-08,278,241,12,253,292,725432,666863,57863,724725,783939,1275,1192,494788,491539
426,2022-02-09,273,331,3,334,276,725705,667194,57866,725059,784215,1267,1188,496055,492727
427,2022-02-10,240,229,7,236,248,725945,667423,57873,725295,784463,1095,1009,497150,493736
428,2022-02-11,283,311,3,314,286,726228,667734,57876,725609,784749,1432,1313,498582,495049
429,2022-02-12,197,207,2,209,199,726425,667941,57878,725818,784948,658,613,499240,495662
430,2022-02-13,98,41,0,41,98,726523,667982,57878,725859,785046,293,273,499533,495935
431,2022-02-14,162,157,2,159,165,726685,668139,57880,726018,785211,830,739,500363,496674
432,2022-02-15,157,214,9,223,166,726842,668353,57889,726241,785377,817,732,501180,497406
433,2022-02-16,184,232,6,238,191,727026,668585,57895,726479,785568,1061,974,502241,498380
434,2022-02-17,200,216,2,218,203,727226,668801,57897,726697,785771,1002,905,503243,499285
435,2022-02-18,254,280,4,284,258,727480,669081,57901,726981,786029,1206,1065,504449,500350
436,2022-02-19,147,147,1,148,149,727627,669228,57902,727129,786178,620,575,505069,500925
437,2022-02-20,75,59,0,59,75,727702,669287,57902,727188,786253,302,263,505371,501188
438,2022-02-21,105,112,2,114,108,727807,669399,57904,727302,786361,503,447,505874,501635
439,2022-02-22,155,170,4,174,160,727962,669569,57908,727476,786521,816,723,506690,502358
440,2022-02-23,156,174,3,177,159,728118,669743,57911,727653,786680,834,754,507524,503112
441,2022-02-24,219,167,6,173,225,728337,669910,57917,727826,786905,770,694,508294,503806
442,2022-02-25,267,206,7,213,274,728604,670116,57924,728039,787179,1040,932,509334,504738
443,2022-02-26,121,108,5,113,126,728725,670224,57929,728152,787305,511,475,509845,505213
444,2022-02-27,65,51,0,51,65,728790,670275,57929,728203,787370,222,205,510067,505418
445,2022-02-28,168,134,4,138,172,728958,670409,57933,728341,787542,835,752,510902,506170
446,2022-03-01,107,101,12,113,120,729065,670510,57945,728454,787662,630,545,511532,506715
447,2022-03-02,117,115,2,117,118,729182,670625,57947,728571,787780,591,520,512123,507235
448,2022-03-03,136,82,8,90,144,729318,670707,57955,728661,787924,619,529,512742,507764
449,2022-03-04,189,177,5,182,195,729507,670884,57960,728843,788119,766,663,513508,508427
450,2022-03-05,111,94,0,94,111,729618,670978,57960,728937,788230,366,338,513874,508765
451,2022-03-06,50,40,0,40,50,729668,671018,57960,728977,788280,157,139,514031,508904
452,2022-03-07,158,94,4,98,162,729826,671112,57964,729075,788442,532,444,514563,509348
453,2022-03-08,126,87,0,87,126,729952,671199,57964,729162,788568,484,422,515047,509770
454,2022-03-09,129,104,5,109,134,730081,671303,57969,729271,788702,521,432,515568,510202
455,2022-03-10,118,135,4,139,122,730199,671438,57973,729410,788824,538,453,516106,510655
456,2022-03-11,190,147,2,149,193,730389,671585,57975,729559,789017,641,552,516747,511207
457,2022-03-12,96,84,2,86,98,730485,671669,57977,729645,789115,310,271,517057,511478
458,2022-03-13,44,33,1,34,45,730529,671702,57978,729679,789160,145,135,517202,511613
459,2022-03-14,112,75,3,78,115,730641,671777,57981,729757,789275,478,386,517680,511999
460,2022-03-15,95,86,8,94,103,730736,671863,57989,729851,789378,484,405,518164,512404
461,2022-03-16,109,83,3,86,112,730845,671946,57992,729937,789490,461,349,518625,512753
462,2022-03-17,119,106,6,112,125,730964,672052,57998,730049,789615,486,373,519111,513126
463,2022-03-18,163,140,3,143,167,731127,672192,58001,730192,789782,607,457,519718,513583
464,2022-03-19,110,74,1,75,110,731237,672266,58002,730267,789892,272,206,519990,513789
465,2022-03-20,59,30,1,31,60,731296,672296,58003,730298,789952,189,131,520179,513920
466,2022-03-21,120,79,1,80,122,731416,672375,58004,730378,790074,472,333,520651,514253
467,2022-03-22,90,57,4,61,94,731506,672432,58008,730439,790168,405,295,521056,514548
468,2022-03-23,94,87,4,91,98,731600,672519,58012,730530,790266,455,337,521511,514885
469,2022-03-24,105,78,4,82,109,731705,672597,58016,730612,790375,467,341,521978,515226
470,2022-03-25,113,98,3,101,117,731818,672695,58019,730713,790492,503,383,522481,515609
471,2022-03-26,81,63,1,64,82,731899,672758,58020,730777,790574,259,197,522740,515806
472,2022-03-27,50,27,0,27,50,731949,672785,58020,730804,790624,188,128,522928,515934
473,2022-03-28,100,94,3,97,103,732049,672879,58023,730901,790727,509,364,523437,516298
474,2022-03-29,89,68,4,72,93,732138,672947,58027,730973,790820,683,342,524120,516640
475,2022-03-30,90,86,1,87,91,732228,673033,58028,731060,790911,1280,399,525400,517039
476,2022-03-31,108,109,3,112,112,732336,673142,58031,731172,791023,1801,501,527201,517540
477,2022-04-01,124,134,5,139,129,732460,673276,58036,731311,791152,2460,415,529661,517955
478,2022-04-02,71,63,1,64,72,732531,673339,58037,731375,791224,1196,180,530857,518135
479,2022-04-03,40,50,0,50,40,732571,673389,58037,731425,791264,762,111,531619,518246
480,2022-04-04,119,133,3,136,122,732690,673522,58040,731561,791386,2744,363,534363,518609
481,2022-04-05,86,96,10,106,97,732776,673618,58050,731667,791483,2343,345,536706,518954
482,2022-04-06,107,106,1,107,108,732883,673724,58051,731774,791591,2247,338,538953,519292
483,2022-04-07,128,103,3,106,132,733011,673827,58054,731880,791723,2528,347,541481,519639
484,2022-04-08,119,170,2,172,121,733130,673997,58056,732052,791844,3099,402,544580,520041
485,2022-04-09,86,53,2,55,88,733216,674050,58058,732107,791932,1527,210,546107,520251
486,2022-04-10,61,27,0,27,61,733277,674077,58058,732134,791993,717,104,546824,520355
487,2022-04-11,106,96,2,98,110,733383,674173,58060,732232,792103,2584,277,549408,520632
488,2022-04-12,136,90,4,94,140,733519,674263,58064,732326,792243,2488,310,551896,520942
489,2022-04-13,155,103,2,105,157,733674,674366,58066,732431,792400,2434,316,554330,521258
490,2022-04-14,129,97,2,99,131,733803,674463,58068,732530,792531,2553,367,556883,521625
491,2022-04-15,162,141,2,143,164,733965,674604,58070,732673,792695,2928,381,559811,522006
492,2022-04-16,110,69,3,72,114,734075,674673,58073,732745,792809,1029,154,560840,522160
493,2022-04-17,73,16,0,16,73,734148,674689,58073,732761,792882,378,64,561218,522224
494,2022-04-18,130,97,1,98,131,734278,674786,58074,732859,793013,2567,290,563785,522514
495,2022-04-19,120,85,4,89,124,734398,674871,58078,732948,793137,2611,297,566396,522811
496,2022-04-20,116,105,2,107,120,734514,674976,58080,733055,793257,2334,321,568730,523132
497,2022-04-21,139,80,1,81,140,734653,675056,58081,733136,793397,2286,314,571016,523446
498,2022-04-22,125,99,4,103,130,734778,675155,58085,733239,793527,2570,324,573586,523770
499,2022-04-23,75,53,0,53,75,734853,675208,58085,733292,793602,941,156,574527,523926
500,2022-04-24,40,22,0,22,40,734893,675230,58085,733314,793642,518,80,575045,524006
501,2022-04-25,89,91,3,94,92,734982,675321,58088,733408,793734,2211,301,577256,524307
502,2022-04-26,93,114,4,118,96,735075,675435,58092,733526,793830,2113,276,579369,524583
503,2022-04-27,107,92,3,95,110,735182,675527,58095,733621,793940,2066,288,581435,524871
504,2022-04-28,110,78,0,78,110,735292,675605,58095,733699,794050,2202,316,583637,525187
505,2022-04-29,119,96,5,101,124,735411,675701,58100,733800,794174,2625,347,586262,525534
506,2022-04-30,59,54,2,56,61,735470,675755,58102,733856,794235,916,182,587178,525716
507,2022-05-01,41,29,1,30,42,735511,675784,58103,733886,794277,489,83,587667,525799
508,2022-05-02,127,85,1,86,129,735638,675869,58104,733972,794406,2208,270,589875,526069
509,2022-05-03,95,63,0,63,95,735733,675932,58104,734035,794501,1849,259,591724,526328
510,2022-05-04,84,105,2,107,86,735817,676037,58106,734142,794587,2139,299,593863,526627
511,2022-05-05,106,77,2,79,108,735923,676114,58108,734221,794695,1899,237,595762,526864
512,2022-05-06,99,94,2,96,102,736022,676208,58110,734317,794797,2323,309,598085,527173
513,2022-05-07,63,56,0,56,63,736085,676264,58110,734373,794860,874,141,598959,527314
514,2022-05-08,41,23,0,23,41,736126,676287,58110,734396,794901,391,71,599350,527385
515,2022-05-09,89,92,3,95,92,736215,676379,58113,734491,794993,2002,288,601352,527673
516,2022-05-10,90,82,1,83,90,736305,676461,58114,734574,795083,1760,240,603112,527913
517,2022-05-11,123,93,3,96,126,736428,676554,58117,734670,795209,2007,276,605119,528189
518,2022-05-12,92,78,3,81,95,736520,676632,58120,734751,795304,2044,292,607163,528481
519,2022-05-13,126,101,1,102,127,736646,676733,58121,734853,795431,2482,346,609645,528827
520,2022-05-14,76,60,0,60,76,736722,676793,58121,734913,795507,980,181,610625,529008
521,2022-05-15,41,25,0,25,41,736763,676818,58121,734938,795548,494,92,611119,529100
522,2022-05-16,113,99,0,99,115,736876,676917,58121,735037,795663,1960,265,613079,529365
523,2022-05-17,96,79,3,82,99,736972,676996,58124,735119,795762,1856,288,614935,529653
524,2022-05-18,109,79,2,81,111,737081,677075,58126,735200,795873,1820,306,616755,529959
525,2022-05-19,103,71,0,71,104,737184,677146,58126,735271,795977,1830,296,618585,530255
526,2022-05-20,139,108,0,108,140,737323,677254,58126,735379,796117,2597,551,621182,530806
527,2022-05-21,99,49,0,49,100,737422,677303,58126,735428,796217,1254,413,622436,531219
528,2022-05-22,32,51,1,52,33,737454,677354,58127,735480,796250,744,306,623180,531525
529,2022-05-23,118,94,4,98,122,737572,677448,58131,735578,796372,2365,580,625545,532105
530,2022-05-24,90,82,2,84,92,737662,677530,58133,735662,796464,2033,570,627578,532675
531,2022-05-25,106,103,3,106,110,737768,677633,58136,735768,796574,2198,661,629776,533336
532,2022-05-26,108,70,2,72,110,737876,677703,58138,735840,796684,1951,579,631727,533915
533,2022-05-27,109,98,1,99,110,737985,677801,58139,735939,796794,2614,822,634341,534737
534,2022-05-28,67,51,1,52,68,738052,677852,58140,735991,796862,1130,502,635471,535239
535,2022-05-29,51,25,0,25,51,738103,677877,58140,736016,796913,597,241,636068,535480
536,2022-05-30,10,7,0,7,10,738113,677884,58140,736023,796923,169,91,636237,535571
537,2022-05-31,116,101,2,103,119,738229,677985,58142,736126,797042,2052,516,638289,536087
538,2022-06-01,109,80,0,80,109,738338,678065,58142,736206,797151,2083,614,640372,536701
539,2022-06-02,100,79,2,81,102,738438,678144,58144,736287,797253,2044,771,642416,537472
540,2022-06-03,121,115,3,118,124,738559,678259,58147,736405,797377,2593,853,645009,538325
541,2022-06-04,78,59,1,60,79,738637,678318,58148,736465,797456,1006,416,646015,538741
542,2022-06-05,35,24,0,24,35,738672,678342,58148,736489,797491,477,174,646492,538915
543,2022-06-06,95,92,2,94,97,738767,678434,58150,736583,797588,1627,545,648119,539460
544,2022-06-07,85,68,0,68,86,738852,678502,58150,736651,797674,1480,439,649599,539899
545,2022-06-08,89,61,3,64,92,738941,678563,58153,736715,797766,1467,425,651066,540324
546,2022-06-09,99,79,1,80,100,739040,678642,58154,736795,797866,1479,434,652545,540758
547,2022-06-10,132,97,3,100,135,739172,678739,58157,736895,798001,1810,551,654355,541309
548,2022-06-11,62,50,0,50,63,739234,678789,58157,736945,798064,680,306,655035,541615
549,2022-06-12,29,22,0,22,29,739263,678811,58157,736967,798093,327,114,655362,541729
550,2022-06-13,85,77,2,79,89,739348,678888,58159,737046,798182,1180,370,656542,542099
551,2022-06-14,71,57,1,58,72,739419,678945,58160,737104,798254,1140,314,657682,542413
552,2022-06-15,106,52,2,54,108,739525,678997,58162,737158,798362,1223,340,658905,542753
553,2022-06-16,94,65,3,68,97,739619,679062,58165,737226,798459,1258,419,660163,543172
554,2022-06-17,115,94,0,94,115,739734,679156,58165,737320,798574,1528,476,661691,543648
555,2022-06-18,44,30,0,30,44,739778,679186,58165,737350,798618,572,215,662263,543863
556,2022-06-19,25,25,0,25,25,739803,679211,58165,737375,798643,275,117,662538,543980
557,2022-06-20,77,44,0,44,77,739880,679255,58165,737419,798720,856,240,663394,544220
558,2022-06-21,132,53,1,54,133,740012,679308,58166,737473,798853,951,271,664345,544491
559,2022-06-22,319,59,1,60,320,740331,679367,58167,737533,799173,1080,310,665425,544801
560,2022-06-23,453,68,2,70,455,740784,679435,58169,737603,799628,1107,340,666532,545141
561,2022-06-24,807,91,2,92,809,741591,679526,58171,737695,800437,1405,497,667937,545638
562,2022-06-25,703,31,0,31,703,742294,679557,58171,737726,801140,452,196,668389,545834
563,2022-06-26,101,14,0,14,101,742395,679571,58171,737740,801241,219,68,668608,545902
564,2022-06-27,562,56,1,57,563,742957,679627,58172,737797,801804,958,281,669566,546183
565,2022-06-28,525,65,0,65,525,743482,679692,58172,737862,802329,911,259,670477,546442
566,2022-06-29,493,62,1,63,494,743975,679754,58173,737925,802823,1043,270,671520,546712
567,2022-06-30,475,48,0,48,475,744450,679802,58173,737973,803298,1044,373,672564,547085
568,2022-07-01,567,57,2,59,570,745017,679859,58175,738032,803868,1098,312,673662,547397
569,2022-07-02,214,30,0,30,214,745231,679889,58175,738062,804082,368,138,674030,547535
570,2022-07-03,47,13,0,13,47,745278,679902,58175,738075,804129,209,59,674239,547594
571,2022-07-04,74,2,1,3,75,745352,679904,58176,738078,804204,51,33,674290,547627
572,2022-07-05,389,67,2,69,391,745741,679971,58178,738147,804595,909,256,675199,547883
573,2022-07-06,321,63,0,63,322,746062,680034,58178,738210,804917,1039,290,676238,548173
574,2022-07-07,358,56,2,58,361,746420,680090,58180,738268,805278,962,270,677200,548443
575,2022-07-08,532,74,3,77,535,746952,680164,58183,738345,805813,1157,308,678357,548751
576,2022-07-09,125,19,1,20,126,747077,680183,58184,738365,805939,448,113,678805,548864
577,2022-07-10,39,15,0,15,39,747116,680198,58184,738380,805978,266,64,679071,548928
578,2022-07-11,283,56,0,56,283,747399,680254,58184,738436,806261,1022,276,680093,549204
579,2022-07-12,329,56,0,55,329,747728,680310,58184,738491,806590,951,275,681044,549479
580,2022-07-13,267,88,1,67,269,747995,680398,58185,738558,806859,1135,243,682179,549722
581,2022-07-14,274,120,2,60,276,748269,680518,58187,738618,807135,1116,262,683295,549984
582,2022-07-15,433,240,1,80,435,748702,680758,58188,738698,807570,1420,337,684715,550321
583,2022-07-16,109,183,0,50,109,748811,680941,58188,738748,807679,594,158,685309,550479
584,2022-07-17,47,51,0,13,47,748858,680992,58188,738761,807726,280,64,685589,550543
585,2022-07-18,237,157,1,65,238,749095,681149,58189,738826,807964,1045,234,686634,550777
586,2022-07-19,263,149,0,72,263,749358,681298,58189,738898,808227,997,254,687631,551031
587,2022-07-20,210,204,0,119,210,749568,681502,58189,739017,808437,928,248,688559,551279
588,2022-07-21,222,272,0,172,223,749790,681774,58189,739189,808660,988,281,689547,551560
589,2022-07-22,334,527,1,359,335,750124,682301,58190,739548,808995,1197,321,690744,551881
590,2022-07-23,141,387,2,324,144,750265,682688,58192,739872,809139,440,121,691184,552002
591,2022-07-24,40,46,0,37,40,750305,682734,58192,739909,809179,217,54,691401,552056
592,2022-07-25,221,348,0,294,221,750526,683082,58192,740203,809400,810,221,692211,552277
593,2022-07-26,181,303,1,240,182,750707,683385,58193,740443,809582,826,254,693037,552531
594,2022-07-27,165,286,2,202,167,750872,683671,58195,740645,809749,743,226,693780,552757
595,2022-07-28,189,297,0,236,189,751061,683968,58195,740881,809938,777,226,694557,552983
596,2022-07-29,286,442,2,291,288,751347,684410,58197,741172,810226,861,272,695418,553255
597,2022-07-30,69,148,0,93,69,751416,684558,58197,741265,810295,316,103,695734,553358
598,2022-07-31,2,0,0,0,2,751418,684558,58197,741265,810297,57,14,695791,553372
